##########################################################
##Pl************************##**************************##
##**####**########**######**##**######**########**####**##
##******************************************************##
##**####**########**##**##########**##**########**####**##
##**####**########**##******##******##**########**####**##
##******************######  ##  ######******************##
##################**##              ##**##################
                ##**##  ####--####  ##**##
                ##**    ##  Gh  ##    **##                
                ##**##  ##########  ##**##               
##################**##              ##**##################
##******************##  ##########  ##******************##
##**########**####**********##**********####**########**##
##********##**####**######**##**######**####**##********##
##**####**##************##******##************##**####**##
##**####**##**########**##**##**##**########**##**####**##
##**************************##**************************##
##########################################################