########################################################
#  ************************##**************************#
#**####**########**######**##**######**########**####**#
#******************************************************#
#**####**########**##**##########**##**########**####**#
#**####**########**##******##******##**########**####**#
#******************######  ##  ######******************#
#################**##              ##**#################
                #**##   ##----##   ##**#
                #**     #GoGoGo#     **#                
                #**##   ########   ##**#               
#################**##              ##**#################
#******************##  ##########  ##******************#
#**########**####**********##**********####**########**#
#********##**####**######**##**######**####**##********#
#**####**##************##******##************##**####**#
#**####**##**########**##**##**##**########**##**####**#
#**************************##**************************#
########################################################